Another late night working on this lab in the CSL. No one else is here. You hear a thump coming from the southwest in the Mac Lab.

 (Type in "directions" at any time to view possible rooms).

Vo-Gone Beta
An Interactive Fiction by Drew Troxell
Release 1 / Serial number 131009 / Inform 7 build 6G60 (I6/v6.32 lib 6/12N) SD

Main Room
The Main Room is filled with the low hum of Lab Computers softly minding their own business.

There is a webcam to the east

You can also see a Lab Computer and a RR door here.

* * *

>look around
You can't see any such thing.

>look
Mac Lab
The Mac computers give off a faint glow.

The room is dimly lit. You can see a light switch.

>switch on light
You switch the light switch on.

The bright light suddenly stings. Looks like some poor guy was working on one of the Mac computers and just fell asleep.

>look
Mac Lab
The Mac computers give off a faint glow.

The corpse lies next to the Mac computer.

You can also see an email here.

>look
Mac Lab
The Mac computers give off a faint glow.

The corpse lies next to the Mac computer.

You can also see an email here.

>look at guy
It's Professor Foaad!

>look at guy
Maybe I should wake him.

>touch guy
Is he... Is he...?

"Dead?" You jump in surprise at the voice behind you. At the door is Nick, the TA for one of your classes.

>talk to nick
"I was upstairs grading some labs. What was the professor doing here?"

>talk to nick
"Something isn't right here. What was the professor working on?"

>talk to nick
"Smells fishy in here. What's on the Mac?"

>look at mac
There seems to be an email being composed.

>read email
"To whoever finds this, I'm not sure what's happening. My cell-phone can't make calls anymore, but I keep getting these text messages. I don't think I have much time left. He's coming for m-"
Nick suddenly starts acting strange. 

"I need to get my stuff upstairs." 

 And he suddenly runs away.

>go northeast
Main Room
The Main Room is filled with the low hum of Lab Computers softly minding their own business.

There is a webcam to the east

You can also see a Lab Computer and a RR door here.

>look at computer
You can access the terminal by logging in a lab computer. You can log in a lab computer by saying "log in lab computer"

>log in lab computer
No use working on your 357 project now, you have a murder to solve!

>go south
Hallway

>go west
Western Stairs

>go up
Waiting Area
From the waiting area you can access Room 301, Room 302, Room 303, the Student Developer Lab 1, the Student Developer Lab 2, the Western Stairs and the Eastern Stairs.

>go to student developer lab1
That noun did not make sense in this context.

>go to student developer lab 1
now going to... Student Developer Lab 1
Student Developer Lab 1
This room is almost completely empty... what is it even used for? The door leads to the Waiting Area.

You can see a flash drive here.

>take flash drive
Taken.

>go to student developer lab 2
now going to... Student Developer Lab 2
Student Developer Lab 2

>look
Student Developer Lab 2

>go to room 301
now going to... Room 301
Room 301
The room is dimly lit. There are several rows of computers, but they are all turned off, except for one. The door leads to the Waiting Area.

You can see a 301computer (on which is a folder (closed)) here.

>look at 301 computer
You can't use multiple objects with that verb.

>look at computer
You can't see any such thing.

>open folder
You open the folder, revealing a video file.

>take file
You ought to focus on Nick clearing his name before snooping around some more.
You want to make sure nick didn't kill the professor.

>go to 302
now going to... Room 302
Room 302
You can see Nick, a friend's computer and a shell here.

>take shell
Taken.

>talk to nick
"Damnit my phone isn't working."

>look at computer
It looks like he was working on a project for the professor. But he could have done that before. 
The last email he sent was at 11pm, that doesn't prove anything.

>read email
You can't see any such thing.

>open email
You can't see any such thing.

>talk to nick
"I know you killed him!"

>drop shell
Dropped.

>go to 301
now going to... Room 301
Room 301
The room is dimly lit. There are several rows of computers, but they are all turned off, except for one. The door leads to the Waiting Area.

You can see a 301computer (on which is a folder (in which is a video file)) here.

>open file
That's not something you can open.

>take video
You ought to focus on Nick clearing his name before snooping around some more.
You want to make sure nick didn't kill the professor.

>turn on lights
You can't see any such thing.

>switch on lighs
You can't see any such thing.

>switch on lights
You can't see any such thing.

>go to waiting area
now going to... Waiting Area
Waiting Area
From the waiting area you can access Room 301, Room 302, Room 303, the Student Developer Lab 1, the Student Developer Lab 2, the Western Stairs and the Eastern Stairs.

>go to 302
now going to... Room 302
Room 302
You can see a shell, Nick and a friend's computer here.

>talk to nick
"Smells fishy in here."

>talk to nick
"Are you sure you're the only other person here?"

>talk to nick
"Are you sure you're the only other person here?"

>go to 303
now going to... Room 303
Room 303

>go to 302
now going to... Room 302
Room 302
You can see a shell, Nick and a friend's computer here.

>look at computer
It looks like he was working on a project for the professor. But he could have done that before. 
The last email he sent was at 11pm, that doesn't prove anything.

* * *

>read email
You can't see any such thing.

>go downstairs
You can't see any such thing.

>go to waiting room
You can't see any such thing.

>go to waiting area
now going to... Waiting Area
Waiting Area
From the waiting area you can access Room 301, Room 302, Room 303, the Student Developer Lab 1, the Student Developer Lab 2, the Western Stairs and the Eastern Stairs.

>go down
Western Stairs

>go down
You can't go that way.

>go east
Hallway

>go north
Main Room
The Main Room is filled with the low hum of Lab Computers softly minding their own business.

There is a webcam to the east

You can also see a Lab Computer and a RR door here.

>go east
(first opening the RR door)
It seems to be locked.

>look at door
You see nothing special about the RR door.

>look
Main Room
The Main Room is filled with the low hum of Lab Computers softly minding their own business.

There is a webcam to the east

You can also see a Lab Computer and a RR door here.

>look around
You can't see any such thing.

>open door
It seems to be locked.

>look at webcam
It's a webcam,  a green light on its is blinking

>inspect webcam
That's not a verb I recognise.

>examine webcam
It's a webcam,  a green light on its is blinking

>examine door
You see nothing special about the RR door.

>examine rack room door
You can't see any such thing.

>examine compuer
You can't see any such thing.

>examine computer
You can access the terminal by logging in a lab computer. You can log in a lab computer by saying "log in lab computer"

>examine lab computer
You can access the terminal by logging in a lab computer. You can log in a lab computer by saying "log in lab computer"

>go to main room
now going to... Main Room
Main Room
The Main Room is filled with the low hum of Lab Computers softly minding their own business.

There is a webcam to the east

You can also see a Lab Computer and a RR door here.

>look at webcam
It's a webcam,  a green light on its is blinking

>look at
What do you want to look at?

>webcam
It's a webcam,  a green light on its is blinking

>look at lab computer
You can access the terminal by logging in a lab computer. You can log in a lab computer by saying "log in lab computer"

>log in lab computer
No use working on your 357 project now, you have a murder to solve!

>access webcam
That's not a verb I recognise.

>look at guy
You can't see any such thing.

>go west
You can't go that way.

* * *

>look at guy
He died wearing a really expensive jacket. You might not want to keep poking him

>look at jacket
It looks warm. Why are there so many pockets?

>look at pockets
In the The winter jacket's pocket is an account info.

>take account info
Taken.

>look around
You can't see any such thing.

>look
Mac Lab
The Mac computers give off a faint glow.

The corpse lies next to the Mac computer.

You can also see an email here.

>look at computer
 Really? Internet Explorer 6?

>look at computer
 Now's not the time for that.

>go north east
I only understood you as far as wanting to go north.

>go north
You can't go that way.

>go east
You can't go that way.

>go to hallway
now going to... Hallway
Hallway

>go north
Main Room
The Main Room is filled with the low hum of Lab Computers softly minding their own business.

There is a webcam to the east

You can also see a Lab Computer and a RR door here.

* * *

>go east
(first opening the RR door)
It seems to be locked.

>open door
It seems to be locked.

>go west
You can't go that way.

>go south
Hallway